111111111
1000C0001
100000E01
10C0P0001
111111111
111111111